1111111111111111111111111111111111111
1000000111111111111111111111111111111
1000000111111110000000000111111111111
1111111111000000000000000000111111111
1000000111111111111111111111111111111
1000000111111110000000000111111111111
1000000111111111111111111111111111111
1000000111111110000000000111111111111
1000000111111111111111111111111111111
1000000111111110000000000111111111111
1000000000000000000000000000000000001
1000000000000000000000000000000000001
1000000000000000000000000000000000001
1111111111111111111111111111111111111