11111111111111111111111111111
10000000001100000000000011111
10110000011100000000000111111
10010000000000000000000111111
11111111101100000111000000001
10000000001100000111011111111
11110111111111011100000010001
11110111111111011101010010001
11000000110101011100000010001
1000000S0000000011000000100011
1000000000000000110101001000111001
1100000111010101111011110011111111
1111011111101011011110100011111
11111111111111111111111111111