
11111111111111111111111111111111
10000000001100000000000011111111
10110000011100000000000111111111
10010000000000000000E00011111111
1111111110110000011100000000000111111111111111111
1000000001100000111011111111111100000000000000011
1111011111111101110000001000111111111111111111111
11110111111111011101010010001111000000000000000001
11000000110101011100000010001111111111111111111011
1000000000000000110000010001111111111111111111111
10000000000000001101010010001111
1100000111010101111101111001111111111111111111111111
1111101111110101101111010001110000000000000000000111
1111111111111111111111111111111111111111111111111111

