11111111111111111111111111111
10000000001100000000000011111
10110000011100000000000111111
10010000000000000000000111111
11111111101100000111000000001
10000000001100000111011111111
11110111111111011100000010001
11110111111111011101010010001
11000000110101011100000010001
1000000S000000001100000010001
10000000000000001101010010001
11000001110101011110111100111
11110111111010110111101000111
11111111111111111111111111111