
1111111111111111111111111
1000000000110000000000001
101100000111000000000001
10010000000000000000E00011
11111111101100000111000000000001
100000000011000001110111111111111
11110111111111011100000010001
11110111111111011101010010001
110000001101			01011100000010001
10000000000000001100000010001
10000000000000001101010010001
1100000111010101E1110111100111
111101111110101101111010001
11111111111111111111111111111

