NO texture/north_texture.xpm
WE texture/west_texture.xpm
EA texture/east_texture.xpm
SO texture/south_texture.xpm

C 0, 50, 200
F 100, 100,, 100

111111
100101
101001
1100N1
111111