NO texture/north_texture.xpm
WE texture/west_texture.xpm
EA texture/east_texture.xpm
SO texture/south_texture.xpm

F 220, 100, 00
C 225, 30, 0

11111111111111111111111111111111
1N000000001100000000000011111111
10110000011100000000000111111111
10010000000000000000000011111111
11111111101100000111000000000001
10000000011000001110111111111111
11110111111111011100000010001111
11110111111111011101010010001111
11000000110101011100000010001111
10000000000000001100000100011111
10000000000000001101010010001111
11000001110101011111011110011111
11110111111010110111101000111111
11111111111111111111111111111111

