NO texture/north_texture.xpm
WE texture/west_texture.xpm
EA texture/east_texture.xpm
SO texture/south_texture.xpm

F 220, 100, 0
C 225, 30, 0

111111111111111111111
110001000000000000001
110000000000000000001
110000000000000000001
110000000000000000001
110000000000000000001
110000N00000000000001
110000000000000000001
110000000000000000001
110000000000000000001
110000000000000000001
110000000000000000001
110000000000000000001
110000000000000000001
111111111111111111111