NO texture/simonkraft/cobblestone.xpm
SO texture/simonkraft/cobblestone_01.xpm
WE texture/simonkraft/mossy_cobblestone1.xpm
EA texture/simonkraft/cobblestone_02.xpm
F 220, 100, 0
C 225, 30, 0

11111111
100N1N01
11111111
