NO texture/north_texture.xpm
WE texture/west_texture.xpm
EA texture/east_texture.xpm
SO texture/south_texture.xpm

F 220, 100, 0
C 225, 30, 0

11111111
100N1  1
11111111