NO texture/new/1.xpm
SO texture/new/1.xpm
WE texture/new/aa.xpm
EA texture/new/lala.xpm

C 0, 0, 0
F 0, 0, 0

11111111111111111111
10000000000000000001
10000000000001000001
10000000000001000001
100000000N0000000001
10000000000000000001
10000000000000000001
10000000000000000001
11111111111111111111
