NO texture/north_texture.xpm
WE texture/west_texture.xpm
EA texture/east_texture.xpm
SO texture/south_texture.xpm

F 220,100,0
C 225,30,0

1111111111111111111111111
1000000000110000000000001
1011000001110000000000001
10010000000000000000000111111111
111111111011000001110000000000001
1000000000110000N1110111111111111
11110111111111011100000010001
 11110111111111011101010010001111
  11000000110101011100000010001111
    10000000000000001100000010001
    1000000000000000110110010001
     1100001 1010101 11101111000111
     11110111 111011 101111010000001
      11111111111111111111111111 11111     111