NO texture/simonkraft/cobblestone.xpm
SO texture/simonkraft/cobblestone_01.xpm
WE texture/simonkraft/mossy_cobblestone1.xpm
EA texture/simonkraft/cobblestone_02.xpm

F 220,100,0
C 225,30,0

111111111111111111111111
  110000000000000000001111
    1000000000000000111
    10000000000000000001111
     110000000000000000111111
     111110000000000000000111111
      111100000N0000011111111111   
111111111111110011111100111111111111111
1111111111111111111111000111111111111111110
111111111111111111111111111111111111111111111